10
**********
*G*      *
* ** *****
*     *  *
*** **** *
*    *   *
* **** ***
* *      *
*    ***C*
**********